-20
20
-10
10
00000000000000000000000000000000000000000
11111111111111111111111111111111111111110
00000000000000000000000000000000000000000
00000000000000000000000000000000000000000
00000000000000000111111100000000000000000
00000000000000000111111100000000000000000
00000000000000000111111100000000000000000
10000000000000000111111100000000000000010
00000000000000000111111100000000000000000
00000000000000000111111100001000000000000
00000000000000000111111100001000000000000
00000000000000000111111100001000000000000
00000000000000000000000000111000000000000
00000000000000000000000000111100000000000
00000000000000000000000000011100000000000
00000000000000000000000000000000000000000
00000000000000000000000000000000000000000
00000000000000000000000000000000000000000
00000000000000000000000000000000000000000
00000000000000000000000000000000000000000
10000000000000000000100000000000000000010
